1,2,3,4,5,6
0,0,4,0,0,0
12,0,0,0,1,0
0,6,0,0,0,1
0,0,0,0,1,0
0,0,0,2,1,0
0,0,0,0,2,0
0,0,5,0,0,0
10,0,4,0,0,0
8,9,5,5,0,1
0,0,0,2,1,1
