1,2,3,4,5,6
0,6,0,0,0,1
12,0,0,0,0,1
0,0,6,0,2,1
9,0,0,4,2,1
11,0,0,0,2,1
0,8,0,0,2,1
8,0,0,0,0,0
0,0,6,0,0,0
0,8,0,0,2,1
11,0,0,4,0,0
