{
    "1": 900,
    "2": 1000,
    "3": 1200,
    "4": 1300,
    "5": 1500,
    "6": 1800,
    "7": 2100,
    "8": 2500,
    "9": 2700,
    "10": 2800,
    "11": 4000,
    "12": 5000
}