1,2,3,4,5,6
0,8,0,0,0,0
0,6,6,0,1,1
0,9,0,0,2,0
0,8,4,0,0,0
9,0,4,0,1,0
8,0,5,0,0,0
0,8,0,5,0,1
0,0,4,0,0,0
0,0,5,0,0,0
0,9,6,2,2,0
