1,2,3,4,5,6
0,8,6,3,1,0
0,0,0,4,0,0
9,7,4,4,1,0
0,0,6,4,0,1
0,0,5,2,0,0
0,0,0,4,0,0
0,7,6,0,0,0
0,0,6,4,0,0
12,0,0,3,2,1
0,7,0,0,1,0
0,0,6,3,0,0
8,0,0,3,0,1
0,8,0,0,0,0
0,0,0,5,0,0
0,8,0,0,0,0
0,9,0,5,0,1
0,9,0,3,0,0
0,0,0,0,1,0
0,0,0,4,0,0
0,0,0,3,0,1
0,0,5,0,0,0
0,0,0,3,2,1
0,0,0,5,0,0
10,0,0,3,2,0
0,0,0,4,0,0
0,0,0,3,0,0
