1,2,3,4,5,6
0,0,0,3,0,0
0,0,0,0,0,1
8,9,0,0,0,0
0,0,0,5,0,0
0,0,6,4,0,0
8,6,0,4,0,0
0,0,0,0,2,0
0,6,0,3,2,0
0,0,5,2,1,0
0,0,0,4,0,0
