1,2,3,4,5,6
0,9,0,5,2,0
9,8,0,0,2,1
0,7,0,4,0,0
0,0,0,2,1,1
0,0,0,5,0,0
11,0,0,0,0,1
12,6,0,0,0,0
11,0,0,5,0,0
0,8,0,4,1,0
0,0,0,2,0,0
