1,2,3,4,5,6
11,0,0,0,2,1
10,0,0,0,0,0
0,0,0,0,0,1
0,0,0,0,0,1
8,8,6,0,1,0
0,0,0,4,1,1
0,6,0,0,0,0
8,0,0,2,2,0
11,0,0,0,0,1
11,0,0,0,0,0
0,0,0,5,0,0
12,0,0,0,0,0
0,0,6,0,0,0
0,6,0,3,0,1
0,7,5,0,0,1
0,0,0,0,2,0
8,0,0,0,0,0
0,0,0,0,1,0
0,0,0,4,0,0
8,9,0,0,0,1
9,0,0,0,1,0
0,6,0,3,2,0
10,0,6,5,0,0
0,0,0,0,0,1
12,0,0,0,0,1
0,6,4,4,0,1
