1,2,3,4,5,6
0,6,0,0,0,0
0,8,0,4,0,0
9,9,4,0,0,0
10,9,0,2,2,1
9,8,4,0,0,0
0,7,0,0,0,0
10,8,0,4,1,0
0,7,4,3,2,0
10,7,0,0,2,0
0,6,0,0,0,0
