1,2,3,4,5,6
8,6,0,0,0,0
9,9,0,0,0,0
8,7,0,0,2,0
0,0,0,2,0,0
12,8,0,5,0,0
10,0,0,0,0,0
0,0,0,3,0,0
0,8,5,0,0,0
0,7,0,0,0,0
0,8,5,0,0,0
