1,2,3,4,5,6
0,7,6,5,2,0
10,0,0,0,1,0
0,8,5,4,1,0
9,0,0,0,0,1
0,0,0,3,0,0
0,0,0,0,2,0
0,8,0,0,1,0
8,0,0,5,2,0
0,0,0,0,2,0
0,0,0,4,0,0
