1,2,3,4,5,6
0,9,0,0,2,0
0,0,0,0,1,0
0,0,5,0,2,0
12,0,0,0,1,0
0,0,0,3,1,0
10,6,0,0,0,0
11,0,5,0,2,1
9,0,0,0,1,0
0,9,4,0,1,0
0,0,0,0,1,0
