1,2,3,4,5,6
0,0,4,2,0,0
0,6,0,4,0,0
0,8,6,2,0,0
8,6,5,3,0,0
0,0,0,2,1,0
0,0,5,5,1,0
0,8,0,0,0,0
0,0,0,4,0,0
0,8,0,3,2,0
0,0,5,0,0,0
8,6,0,0,1,0
0,0,0,3,0,0
0,0,0,0,2,1
0,0,0,2,0,0
8,0,0,4,0,0
0,0,0,3,0,0
0,8,0,5,0,0
0,0,0,0,1,0
0,0,0,0,1,1
8,8,0,0,0,0
0,0,4,5,2,0
8,0,0,2,2,0
0,0,5,0,1,0
9,0,0,0,1,1
0,7,0,2,0,0
8,9,0,0,0,0
0,0,6,4,0,0
0,0,0,4,0,0
9,0,0,0,0,0
0,7,6,0,0,0
0,9,0,4,0,0
0,9,0,0,0,0
0,0,0,3,0,1
0,6,0,0,0,0
12,0,4,0,0,0
0,9,4,2,0,1
0,7,6,3,0,0
0,0,5,0,1,0
0,0,0,4,0,0
12,0,0,2,0,0
0,0,0,3,2,0
0,8,5,3,0,0
8,0,0,2,2,0
0,0,0,4,2,0
12,0,5,3,0,0
0,0,0,3,0,1
0,0,0,0,1,0
10,0,0,2,0,0
0,8,5,5,0,0
0,0,0,5,0,0
0,0,5,5,0,0
0,0,6,0,0,0
