1,2,3,4,5,6
0,6,0,5,1,0
12,9,0,0,0,0
0,8,0,2,0,0
0,0,4,0,0,0
0,0,0,2,0,0
0,6,6,0,2,0
0,0,0,0,1,0
12,0,0,4,0,0
0,0,0,0,2,0
0,0,6,3,0,1
0,0,6,4,0,1
0,6,0,0,0,0
0,8,0,5,0,0
0,0,0,0,2,0
0,0,6,5,0,0
0,0,6,4,1,0
0,0,4,0,1,0
0,0,0,2,0,0
8,9,0,2,1,0
0,8,0,0,0,0
0,0,0,5,1,0
11,7,6,0,0,0
11,0,4,2,0,0
0,0,0,3,0,0
0,8,0,0,1,0
0,9,0,4,0,0
0,0,0,3,0,0
0,0,0,2,0,0
9,0,0,5,2,0
0,0,0,5,0,0
0,0,0,3,0,0
0,0,5,0,0,0
12,0,6,5,0,0
12,9,6,0,0,0
0,7,6,0,0,0
9,0,0,0,0,0
0,0,0,3,0,1
0,6,0,0,1,0
0,8,0,2,0,0
9,7,0,0,0,0
0,0,0,2,0,0
10,7,6,0,0,0
0,9,0,4,0,1
0,9,0,5,0,0
0,0,0,2,0,0
0,0,0,3,0,1
0,0,0,3,1,0
11,0,0,5,0,0
11,0,0,4,0,0
0,0,0,2,0,0
0,0,0,4,0,0
0,0,0,5,0,0
