1,2,3,4,5,6
8,0,0,2,1,0
0,7,6,0,1,0
0,0,6,0,0,0
0,0,4,0,1,0
0,8,0,4,0,0
0,6,0,4,0,0
0,8,6,0,0,1
0,7,6,0,0,0
11,0,0,4,0,0
0,0,6,0,1,0
0,0,0,0,2,0
11,0,5,4,1,0
0,0,0,2,1,0
0,6,0,0,0,0
0,0,0,0,1,0
11,0,0,0,1,0
0,0,5,2,2,1
12,0,4,0,0,1
0,0,5,5,1,0
12,0,0,2,2,0
0,0,0,3,0,0
0,7,0,0,2,0
11,0,6,0,2,0
0,0,0,0,2,0
0,0,0,0,2,0
0,7,0,0,0,0
