1,2,3,4,5,6
9,9,0,3,1,0
10,0,0,0,2,0
0,7,0,2,1,0
0,0,0,0,2,0
0,0,4,2,1,0
0,0,0,5,2,0
0,0,4,0,1,1
10,0,5,5,1,0
0,6,0,0,1,0
10,0,0,0,2,1
0,0,5,3,1,0
11,0,0,0,0,0
11,0,5,0,2,0
0,7,0,2,1,0
0,0,0,3,1,0
12,0,4,0,0,0
0,0,0,0,0,1
0,8,0,0,1,0
0,0,0,0,2,1
0,8,0,0,2,0
0,0,5,0,2,0
0,0,4,0,0,0
0,6,0,0,0,1
0,8,4,0,2,0
0,0,0,0,1,0
0,0,0,0,1,0
