1,2,3,4,5,6
0,6,0,3,2,0
12,0,0,4,0,0
0,7,4,5,0,1
0,0,0,0,2,0
0,0,0,2,2,0
0,0,0,2,0,0
11,0,4,0,1,1
0,7,4,0,1,0
0,0,0,0,2,0
10,0,0,0,2,0
0,0,0,5,1,0
8,0,0,0,1,0
10,0,5,0,2,0
12,0,5,0,1,1
0,0,0,2,0,0
10,0,5,0,2,0
0,0,6,0,1,0
0,0,0,3,1,1
12,0,0,0,0,0
0,0,0,0,2,0
12,8,5,0,2,0
0,9,6,5,0,0
0,0,0,0,2,0
0,9,0,0,0,1
0,0,4,0,1,0
0,0,6,4,1,0
