1,2,3,4,5,6
0,0,0,0,2,0
0,0,0,4,1,0
0,0,0,2,0,1
9,8,5,2,2,0
0,0,5,0,1,0
0,0,0,0,0,1
11,0,4,5,2,1
0,0,6,4,0,0
0,0,0,5,0,0
9,0,0,0,0,0
12,0,0,0,0,0
9,0,0,0,1,1
0,8,6,3,0,1
0,0,0,5,0,1
12,0,5,0,0,0
0,8,5,0,1,0
0,6,0,0,2,1
0,0,0,2,0,0
0,6,0,0,2,0
0,0,6,0,0,0
0,0,0,5,0,0
8,0,0,4,0,0
0,0,0,0,2,0
0,0,5,0,0,0
0,6,4,0,0,0
0,0,5,0,0,0
0,0,0,2,0,0
0,9,0,0,0,1
9,0,6,4,0,0
0,0,0,0,1,0
0,8,0,0,0,0
0,0,0,0,0,1
0,6,0,0,0,1
12,8,0,5,0,1
0,8,0,0,0,1
0,0,6,4,0,0
0,0,0,0,0,1
0,9,4,4,0,0
0,0,0,0,1,1
0,0,0,3,0,0
0,6,0,0,0,0
9,0,5,4,0,0
10,0,0,0,2,0
0,0,4,0,0,0
0,0,4,4,0,0
11,0,0,0,0,1
0,7,0,0,0,0
0,0,5,0,0,1
0,0,4,0,0,0
9,0,5,0,0,0
0,0,0,3,2,0
0,0,0,3,2,1
0,0,5,2,0,1
0,0,5,0,0,0
0,0,5,0,0,0
0,6,0,4,0,0
0,7,0,0,0,1
0,7,5,5,0,1
0,9,0,3,0,1
0,0,0,0,0,1
0,6,6,0,0,0
11,0,0,4,1,0
0,7,4,0,0,1
0,8,0,2,0,0
11,0,6,0,0,0
11,0,0,0,2,0
9,6,0,5,1,0
0,8,0,4,2,0
9,0,0,0,0,0
0,0,5,0,0,0
0,0,0,4,0,0
9,6,0,2,0,0
0,0,6,0,0,0
0,0,4,5,0,1
0,0,0,2,0,1
11,0,4,0,0,0
0,0,5,3,1,0
12,0,0,3,0,0
0,9,0,0,0,0
0,0,0,2,0,0
8,8,0,0,2,0
0,0,0,2,1,1
0,0,0,3,0,1
9,9,0,2,0,0
11,0,0,0,0,0
8,0,0,0,0,1
0,0,5,2,0,1
10,0,0,0,0,1
0,8,0,0,0,0
0,8,0,0,0,0
0,0,6,4,2,1
12,0,0,3,0,1
10,8,0,0,0,1
0,0,4,0,0,0
0,0,0,0,0,1
0,7,0,0,1,0
0,0,0,0,1,0
0,9,0,0,0,0
0,8,0,0,0,0
0,0,0,2,0,0
0,0,0,5,0,0
0,6,0,0,0,1
10,0,4,0,0,1
10,6,0,4,0,0
0,0,6,0,0,0
