1,2,3,4,5,6
9,9,0,2,0,0
0,8,0,0,0,0
0,9,5,0,0,0
0,0,5,2,0,0
0,0,4,0,0,0
0,6,5,0,0,0
0,0,5,0,0,0
0,7,5,0,0,0
0,0,4,0,0,0
10,6,5,0,0,0
0,0,6,0,0,0
0,0,5,0,2,0
0,0,5,4,1,0
0,0,0,2,2,0
0,0,6,0,0,0
0,8,0,2,0,0
0,7,6,0,0,1
0,0,6,0,0,1
0,0,6,0,0,0
0,9,5,0,0,0
10,9,4,0,0,0
8,0,4,0,2,0
11,0,6,0,0,0
9,0,6,0,1,0
0,0,4,0,1,0
0,0,4,0,2,0
0,7,4,0,0,0
9,0,6,0,1,0
0,9,6,5,0,0
0,0,4,0,2,0
0,0,5,0,2,1
0,0,6,0,0,0
0,0,0,3,0,0
0,0,0,3,1,0
0,0,4,4,1,0
0,7,0,0,0,0
0,0,6,0,0,0
9,0,0,0,2,0
12,0,6,0,1,0
11,0,4,0,0,0
0,0,0,2,1,0
0,0,4,3,1,0
0,6,5,0,1,0
0,8,0,0,0,0
9,0,4,2,0,0
0,0,4,4,2,0
0,0,0,2,0,0
0,9,0,4,0,0
9,0,0,0,0,0
12,7,4,2,1,0
0,0,6,0,0,0
0,0,5,0,0,0
